operating system: 作業系統; 操作系統
program: 程式; 程序
programmer: 程式設計員; 程序員
computer: 電腦*; 電腦，計算機
source code: 原始程式碼; 源碼
software: 軟體; 軟件*
hardware: 硬體; 硬件*
compile: 編譯
script: 脚本
library: 程序庫
database: 資料庫; 數據庫
engine: 引擎
backup: 備份
environment: 環境

disk: 片; 盤; 碟
CD-ROM: 光盤, 光碟, CD-ROM，

kernel: 核心; 內核
module: 模組; 模塊
boot: 開機, 啟動
dual boot: 雙重引導

free software: 自由軟體; 自由軟件*
open source: 開放原始碼; 開放源碼*
license: 許可證
constitution: 憲章*, 憲法
terms: 條款
conditions: 條件
copyright: 版權, 版權所有

Internet: 互聯網*, 因特網, 網際網絡
WWW: 萬維網 (?)
server: 伺服器, 服務器*
archive: 軟件庫
web site: 網站, 站台
home page: 主頁, 首頁
main page: 主頁, 首頁
web page: 網頁
mirror: 映射; 鏡像
index: 索引
search: 搜索
mailing list: 通訊論壇, 郵遞表
resource(s): 資源
newsgroup: 新聞組
subscribe: 訂閱
subscription:
unsubscribe: 退訂, 取消訂閱
upload: 上傳, 上載
download: 下載

maintainer: 維護者, 維護人員
developer: 開發者, 開發人員
join: 加入, 加盟
package: 套件, 軟件包
distribution: 發布? 發布名? 配套?, 安裝套件?, 發行版本
release: 發行?, 發布?
install: 安裝
upgrade: 升級
template: 模版
bundle: 捆綁???
configuration: 配置
settings: 設置

# 指南, 使用說明, 參考, 參考文獻
introduction: 入門, 介紹, 簡介?
documentation: 文档, 文案, 文件
guide: 指南, 導引
primer: 入门?
how to: 如何
reference: 參考

# 一些专有名词
Linux HOWTOs: Linux 实用指南?
Linux Documentation Project: Linux 文档计划?
DFSG (Debian Free Software Guideline): Debian 自由软件指导标准
FSF (Free Software Foundation): 自由软件基金会
Apache: 阿帕奇 ;)
LUG (Linux Users Group): Linux 用户协会，Linux 用户俱乐部
man pages: 手册页?

# 一些俚语
guru: 大师?
hacker: 黑客? 海客? 程序员? (Think about Linux Kernel Hackers' Guide)
cracker: 
nerd:
geek:
